NO ./textures/op1.png
SO ./textures/op2.png
WE ./textures/op3.png
EA ./textures/b.png
F 220,100,0
C 225,30,0

 11111111111111111111111
11001111111111111111001
10000000000000000000001
11100000000111000000011
1000010000100110000111
1000100000100011000111
1011000N00100001100111
1000000000100000100111
1000000000100000000111
1000000000111111100111
1000000000100000100111
1000000000100111100111
1000000000100000000111
1100011111111111111111
1000000001000000000111
1000001110000000000111
1000000000000000000111
1000000000111111100111
1000000000100000100111
1000000000100111100111
1000000000100000000111
1111111111111111111111
