NO ./textures/red.png
SO ./textures/green.png
WE ./textures/yellow.png
EA ./textures/purple.png
F 220,100,0
C 225,30,0

   111111111111111111111111111111111111111111111111111111111111111111111
11110011111111111111110010100111111111111111100101001111111111111111001
11100000000000000000000010000000000000000000000100000000000000000000001
11111000000000000000000110110000000000000000001101100000000000000000011
1110000100000000000001110000001000000000000011100000010000000000000111
1110001000000000000001110000010000000000000011100000100000000000000111
1110110000000000000001110001100000000000000011100011000000000000000111
11100000000000N0000000000000000000000000000000000000000000000000000111
1110000000010000000001110000000000100000000011100000000001000000000111
1110000011100000000001110000000111000000000011100000001110000000000111
1110000000000000000001110000000000000000000011100000000000000000000111
1110000000001111111001110000000000011111110011100000000000111111100111
1110000000001000001001110000000000010000010011100000000000100000100111
1110000000001001111001110000000000010011110011100000000000100111100111
1110000000001000000001110000000000010000000011100000000000100000000111
1110001111111111111111110011111111111111111111100111111111111111111111
111100111111111111111111111111111111111111111111111111111111111111111111
11110011111111111111110010100111111111111111100101001111111111111111001
11100000000000000000000010000000000000000000000100000000000000000000001
11111000000000000000000110110000000000000000001101100000000000000000011
1110000100000000000001110000001000000000000011100000010000000000000111
1110001000000000000001110000010000000000000011100000100000000000000111
1110110000000000000001110001100000000000000011100011000000000000000111
1110000000000000000001110000000000000000000011100000000000000000000111
1110000000010000000001110000000000100000000011100000000001000000000111
1110000011100000000001110000000111000000000011100000001110000000000111
1110000000000000000001110000000000000000000011100000000000000000000111
1110000000001111111001110000000000011111110011100000000000111111100111
1110000000001000001001110000000000010000010011100000000000100000100111
1110000000001001111001110000000000010011110011100000000000100111100111
1110000000001000000001110000000000010000000011100000000000100000000111
11111111111111111111111111111111111111111111111111111111111111111111
