NO ./sprites/test1.png
SO ./sprites/test2.png
WE ./sprites/test3.png
EA ./sprites/test4.png
F 220,100,0
C 225,30,0

 11111111111111111111111
11001111111111111111001
10000000000000000000001
11100000000000000000011
1000010000000000000111
1000100000000000000111
1011000N00000000000111
1000000000000000000111
1000000001000000000111
1000001110000000000111
1000000000000000000111
1000000000111111100111
1000000000100000100111
1000000000100111100111
1000000000100000000111
1111111111111111111111
