NO ./sprites/red.png
SO ./sprites/green.png
WE ./sprites/yellow.png
EA ./sprites/purple.png
F 220,100,0
C 225,30,0

 111111111
110011001
100000001
11100E011
10000111
10000111
10110111
10000111
11111111
