NO ./textures/red.png
SO ./textures/green.png
WE ./textures/yellow.png
EA ./textures/purple.png
F 220,100,0
C 225,30,0

11111111111111111111111111111111111111111111111111111111111
10000000000000000000000000000000000000000000000000000000001
1001111E000000000000000000000000000000000000000000000000001
10100000000000000000000000000000000000000000000000000000001
10100000000000000000000000000000000010000000000000000000001
10110000000000000000000000000000000100011111111111111111101
10001000000000000000000000000000000000010000000000000000001
10000100000000000000000000000000000000000000000000000000001
10000100000000000000000000000000000000000000000000000000001
10000100000000000000000000000000000000000000000000000000001
10000100000000000000000000000000000000000000000000000000001
10000100000000000000000000000000000000000000000000000000001
10000100000000000000000000000000000000000000000000000000001
10000100000000000000000000000000000000000000000000000000001
10000100000000000000000000000000000000000000000000000000001
10000100000000000000000000000000000000000000000000000000001
10000000000000000000000000000000000000000000000000000000001
10000000000000000000000000000000000000000000000000000000001
10000100000000000000000000000000000000000000000000000000001
10000000000000000000000000000000000000000000000000000000001
10000000000000000000000000000000000000000000000000000000001
10000100000000000000000000000000000000000000000000000000001
10000000000000000000000000000000000000000000000000000000001
10000000000000000000000000000000000000000000000000000000001
10000000000000000000000000000000000000000000000000000000001
10000000000000000000000000000000000000000000000000000000001
10000000000000000000000000000000000000000000000000000000001
10000000000000000000000000000000000000000000000000000000001
10000000000000000000000000000000000000000000000000000000001
10000000000000000000000000000000000000000000000000000000001
11111111111111111111111111111111111111111111111111111111111
