NO ./sprites/red.png
SO ./sprites/green.png
WE ./sprites/yellow.png
EA ./sprites/purple.png
F 220,100,0
C 225,30,0

 1111111111111
1100111111001
1000000000001
1110000000011
100001000111
10001N000111
101100000111
100000000111
111111111111
