NO ./textures/op1.png
SO ./textures/op2.png
WE ./textures/op3.png
EA ./textures/b.png
F 220,100,0
C 225,30,0

   111111111111111111111111111111111111111111111111111111111111111111111
11110011111111111111110000000001111111111111100101001111111111111111001
11100000000000000000000000000000000000000000000100000000000000000000001
11111000000000000000000100000000000000000000001100011111111111111100011
1110000100000000000001110000000000000000000011100111000000000000010111
1110001000000000000001110000000000000000000011101100000111111100010111
1110110000000000000001110000000000000000000011111000111100000100010111
1110000000000000000000000000000111000000000000000001000100000000010111
1110000000010000000001110000000000100000000011100111110111111111010111
1110000011100000000001110000000001000000000011100100000000000001010111
1110000000000000000001110000000010000000000011100100100000000001010111
1110000000001111111001110000000110000000000011100100111111111111010111
1110000000001000001001110000000001000000000011100100000000000000010111
1110000000001001111001110000000000110000000011100111111111111111110111
0110000000001000000001110000000000001110000011100000001000000000000111
1110001111111111111111110000000000000000000011100111111000001111111111
111100111111111111111111000000000000000000001111111111100000111111111111
11110011111111111111110000000000000000000000100101001110000011111111001
11100000000000000000000000000000000000000000000100000000000010000100001
11111000000000000000000100000000000000000000001101100000001010000100011
1110000100000000000001110000000000000000000011100010000000100000010111
1110001000000000000001110000000000000000000011100010111100101111100111
1110110000000000000001110000000000000000000011100010100100101000000111
1110000000000000000001110000000000000000000011100010100111101000000111
1110000000011000000001110000000000000000000011100010100000001111000111
1110000011101000000000000000000000000000000000000010100100101001111111
1110000000001000000001110000000000000000000011100010100100101000000111
1110000000001111111001110000000000000000000011100010100100100001000111
1110000000000000001001110000000000000000000011100010100100101111000111
1110000000000001111001110000000000000000000011100011100100101000000111
1110000000000000000001110000000000000000000011100000000100101000000111
11110011111111111111110000000000000000000000100101001110000011111111001
11100000000000000000000000000000000000000000000100000000000010000100001
11111000000000000000000100000000000000000000001101100000001010000100011
1110000100000000000001110000000000000000000011100010000000100000010111
1110001000000000000001110000000000000000000011100010111100101111100111
1110110000000000000001110000000000000000000011100010100100101000000111
1110S00000000000000001110000000000000000000011100010100111101000000111
1110000000011000000001110000000000000000000011100010100000001111000111
1110000011101000000000000000000000000000000000000010100100101001111111
1110000000001000000001110000000000000000000011100010100100101000000111
1110000000001111111001110000000000000000000011100010100100100001000111
1110000000000000001001110000000000000000000011100010100100101111000111
1110000000000001111001110000000000000000000011100011100100101000000111
1110000000000000000001110000000000000000000011100000000100101000000111
1111000111111111111111111111111111111111111111111111111111111111111111
1000000011111111111111
1000000000000000000001
1000000000000000000001
1000000000000000000001
1000000000000000000001
1000000000000000000001
1000000011100000000001
1000000000010000000001
1000000000100000000001
1000000001000000000001
1000000011000000000001
1000000000100000000001
1000000000011000000001
1000000000000111000001
1000000000000000000001
1000000000000000000001
1000000000000000000001
1000000000000000000001
1000000000000000000001
1000000000000000000001
1000000000000000000001
1000000000000000000001
1000000000000000000001
1000000000000000000001
1000000000000000000001
1000000000000000000001
1000000000000000000001
1000000000000000000001
1000000000000000000001
1000000000000000000001
1000000000000000000001
1000000000000000000001
1000000000000000000001
1000000000000000000001
1000000000000000000001
1000000000000000000001
1000000000000000000001
1000000000000000000001
1000000000000000000001
1000000000000000000001
1000000000000000000001
1000000000000000000001
1000000000000000000001
1000000000000000000001
1000000011111111111111
1000000011111111111111
1000000000000000000001
1000000000000000000001
1000000000000000000001
1000000000000000000001
1000000000000000000001
1000000011100000000001
1000000000010000000001
1000000000100000000001
1000000001000000000001
1000000011000000000001
1000000000100000000001
1000000000011000000001
1000000000000111000001
1000000000000000000001
1000000000000000000001
1000000000000000000001
1000000000000000000001
1000000000000000000001
1000000000000000000001
1000000000000000000001
1000000000000000000001
1000000000000000000001
1000000000000000000001
1000000000000000000001
1000000000000000000001
1000000000000000000001
1000000000000000000001
1000000000000000000001
1000000000000000000001
1000000000000000000001
1000000000000000000001
1000000000000000000001
1000000000000000000001
1000000000000000000001
1000000000000000000001
1000000000000000000001
1000000000000000000001
1000000000000000000001
1000000000000000000001
1000000000000000000001
1000000000000000000001
1000000000000000000001
1000000000000000000001
1111111111111111111111
