NO ./textures/op1.png
SO ./textures/op2.png
WE ./textures/op3.png
EA ./textures/b.png
F 220,100,0
C 225,30,0

111111111111111111111111
1       111111111111001
1  N    000000000000001
1       000111000000011
1       00100110000111
1       00100011000111
1       00100001100111
1       00100000100111
1       00100000000111
1       00111111100111
1       00100000100111
1       00100111100111
1       00100000000111
1       11111111111111
1       01000000000111
1       10000000000111
1       00000000000111
1       00111111100111
1       00100000100111
1       00100111100111
1       00100000000111
1111111111111111111111
